Кыргыз Республикасынын Президенти Садыр Жапаров кол койгон жарлыктарга ылайык, Кыргыз Республикасынын Президентинин Администрациясынын түзүмдүк бөлүмдөрүнүн жетекчилери дайындалды.
Мамлекет башчысынын жарлыктарына ылайык:
- Султанбаев Эрбол Абдыкадырович – Кыргыз Республикасынын Президентинин басма сөз катчысы болуп дайындалды;
- Жаманбаев Муса Мураталиевич – Кыргыз Республикасынын Президентинин Администрациясынын Президенттин протокол кызматынын жетекчиси болуп дайындалды;
- Калматов Анарбек Баратович – Кыргыз Республикасынын Президентинин Кыргыз Республикасынын Жогорку Кеңешиндеги ыйгарым укуктуу өкүлү болуп дайындалды;
- Абытов Алмасбек Ахунжанович – Кыргыз Республикасынын Министрлер Кабинетинин Кыргыз Республикасынын Жогорку Кеңешиндеги ыйгарым укуктуу өкүлү болуп дайындалды;
- Жусупов Медер Кеңешович – Кыргыз Республикасынын Президентинин жана Министрлер Кабинетинин Конституциялык сотунун ыйгарым укуктуу өкүлү болуп дайындалды;
- Марс Нурай – Кыргыз Республикасынын Президентинин Администрациясынын маалыматтык саясат бөлүмүнүн башчысы болуп дайындалды;
- Иминов Махамаджан Саитович – Кыргыз Республикасынын Президентинин Администрациясынын Президенттин укуктук жактан камсыз кылуу бөлүмүнүн башчысы болуп дайындалды;
- Естебесов Адыл Жээнбекович – Кыргыз Республикасынын Президентинин Администрациясынын Министрлер Кабинетинин укуктук жактан камсыз кылуу бөлүмүнүн башчысы болуп дайындалды;
- Базарбеков Замирбек Курамаевич – Кыргыз Республикасынын Президентинин Администрациясынын соттор жана прокуратура органдары менен өз ара аракеттенүү бөлүмүнүн башчысы болуп дайындалды;
- Дюшекеев Дастан Станбекович – Кыргыз Республикасынын Президентинин Администрациясынын тышкы саясат бөлүмүнүн башчысы болуп дайындалды;
- Айдарбеков Айбек Акматбекович – Кыргыз Республикасынын Президентинин Администрациясынын эл аралык кызматташтык бөлүмүнүн башчысы болуп дайындалды;
- Бакиров Жетиген Жокинович – Кыргыз Республикасынын Президентинин Администрациясынын мамлекеттик, муниципалдык кызмат жана кадр саясаты бөлүмүнүн башчысы болуп дайындалды;
- Орозалиев Акылбек Атабекович – Кыргыз Республикасынын Президентинин Администрациясынын инспектордук-контролдоо иштери бөлүмүнүн башчысы болуп дайындалды;
- Жалалов Жаныбек Махматалиевич – Кыргыз Республикасынын Президентинин Администрациясынын уюштуруу-инспектордук иштер жана аймактар менен өз ара аракеттенүү бөлүмүнүн башчысы болуп дайындалды;
- Керимжанов Алтынбек Жамалбекович – Кыргыз Республикасынын Президентинин Администрациясынын кадрлар бөлүмүнүн башчысы болуп дайындалды;
- Мурзаканов Санжар Равшанбекович – Кыргыз Республикасынын Президентинин Администрациясынын жарандардын кайрылуулары менен иштөө бөлүмүнүн башчысы болуп дайындалды;
- Беков Аскат Турдумаматович – Кыргыз Республикасынын Президентинин Администрациясынын стратегиялык өнүктүрүү саясаты жана пландоо бөлүмүнүн башчысы болуп дайындалды;
- Абдыкалыков Жанузак Козубайевич – Кыргыз Республикасынын Президентинин Администрациясынын экономика жана финансы бөлүмүнүн башчысы болуп дайындалды;
- Кулуев Алымкул Раимкулович – Кыргыз Республикасынын Президентинин Администрациясынын агроөнөр жай комплекси жана экология бөлүмүнүн башчысы болуп дайындалды;
- Оморов Азамат Каныбекович – Кыргыз Республикасынын Президентинин Администрациясынын өнөр жай, отун-энергетикалык комплекси жана жер казынасын пайдалануу бөлүмүнүн башчысы болуп дайындалды;
- Узаков Азат Сапарбаевич – Кыргыз Республикасынын Президентинин Администрациясынын курулуш, транспорт, жол жана коммуникациялар бөлүмүнүн башчысы болуп дайындалды;
- Байтереков Таалай Алымбекович – Кыргыз Республикасынын Президентинин Администрациясынын санариптик өнүктүрүү бөлүмүнүн башчысы болуп дайындалды;
- Усубалиев Максат Абдыкадырович – Кыргыз Республикасынын Президентинин Администрациясынын саламаттык сактоо жана социалдык коргоо бөлүмүнүн башчысы болуп дайындалды;
- Байтерек Галина Жумабековна – Кыргыз Республикасынын Президентинин Администрациясынын билим берүү, илим, маданият, спорт жана жаштар бөлүмүнүн башчысы болуп дайындалды;
- Базарбаев Кудайберген Базарбаевич – Кыргыз Республикасынын Президентинин Администрациясынын жарандык коомдун институттары менен өз ара аракеттенүү, дин иштери жана этностор аралык мамилелер боюнча бөлүмүнүн башчысы болуп дайындалды;
- Абдрахманова Чолпон Садырбековна – Кыргыз Республикасынын Президентинин Администрациясынын Канцеляриясынын начальниги болуп дайындалды;
- Абдысадыр уулу Азат – Кыргыз Республикасынын Президентинин Администрациясынын канцеляриясынын Президенттин жана Министрлер Кабинетинин актыларын, башка актыларды редакциялоо жана котормо бөлүмүнүн башчысы болуп дайындалды;
- Рахматова Жанна Аскербековна – Кыргыз Республикасынын Президентинин Администрациясынын канцеляриясынын Президенттин жана Министрлер Кабинетинин актыларын, башка актыларды чыгаруу бөлүмүнүн башчысы болуп дайындалды;
- Шукурбеков Улугбек Абдималикович Кыргыз Республикасынын Президентинин Администрациясынын Жарандык боюнча комиссиянын жооптуу катчысы болуп дайындалды;
- Апенов Таалайбек Бекболотович Кыргыз Республикасынын Президентинин Администрациясынын Ырайым кылуу боюнча комиссиянын жооптуу катчысы болуп дайындалды;
- Сманбаева Жылдыз Аскарбековна Кыргыз Республикасынын Президентинин Администрациясынын Мамлекеттик сыйлыктар боюнча комиссиянын жооптуу катчысы болуп дайындалды.
Ошондой эле Президент Садыр Жапаров кол койгон Жарлыкка ылайык, Мамбетов Алмаз Ишенбекович Кыргыз Республикасынын Президентинин иш башкаруучусу болуп дайындалды.
- Мамбеталиев Мирбек Кемелович Кыргыз Республикасынын Президентинин иш башкаруучусунун биринчи орун басары болуп дайындалды;
- Шерматов Эмил Абсатарович Кыргыз Республикасынын Президентинин иш башкаруучусунун орун басары болуп дайындалды.
